16 12
0 1 2 0 1 2 0 1 2 0 1 2 0 1 2 0 
1 2 0 1 2 0 1 2 0 1 2 0 1 2 0 1 
2 0 3 6 6 6 6 6 6 6 6 6 6 9 1 2 
0 1 4 7 7 7 7 7 7 7 7 7 7 10 2 0 
1 2 4 7 8 8 8 8 8 8 8 7 7 10 0 1 
2 0 4 10 0 1 2 0 1 2 0 4 7 10 1 2 
0 1 4 10 1 3 9 1 2 0 1 4 7 10 2 0 
1 2 4 10 2 5 11 2 0 1 2 4 7 10 0 1 
2 0 4 10 0 1 2 0 1 2 0 4 7 10 1 2 
0 1 4 7 6 6 6 9 2 0 1 5 8 11 2 0 
1 2 5 8 8 8 8 11 0 1 2 0 1 2 0 1 
2 0 1 2 0 1 2 0 1 2 0 1 2 0 1 2